0323132221
1113312102
0010321032
2101033123
3200100103
2110100233
0212111033
0100111030
2132122231
3333321233
0122132301
1121031131
0322100213
0332111002
0233032201
