1031013311
2133331122
3101120222
3011133323
2022023100
0230023103
1330122003
2012233331
0322111022
0333030110
2212303123
1010330102
0221010022
3013000221
2310130003
