1010030023
0023202322
0132131102
1101303001
0030220333
1022310132
1132220033
1203122022
0313233020
3230322321
2202212200
2133333002
2002022113
3031310003
3220102101
