3112203100
2333321033
3001101222
1133031222
3332101223
3202201100
2011102320
3223123020
2213320310
1223122111
0300102333
0210233223
1113100231
0232223320
1031232103
