0010000101
0011111110
0011011100
1010001110
1111111110
1100010010
0001001010
0111110000
0100011111
1101110111
1100101110
1111011011
0001010010
0010110110
1001001011
