0102233300
1331232310
1112030122
2023032231
3112023322
1303122313
2221010201
1323212022
3212233301
0303023320
3220311023
1111332103
2011333220
1131121330
1001323230
