
0011110111
1110110110
0100000110
0001110110
1000001001
1111101001
0001110010
0001011101
1101000100
1101110010
0011111010
0001111110
0011001110
1010010010
0011101110