2331312003
2101102212
0213320230
2333013311
0111201101
1233231011
3312100010
1001202210
2033120313
0311033131
3102120110
1212100221
1022022332
0020100310
0113311123
