0303020211
1220113033
3113123320
2311122002
3031013133
0231012111
1212301113
1211313032
1211132010
3122012233
0031230020
0321203110
0310010202
0032231022
3021200233
