1132121022232000
2311213032200331
1203213003032331
2302032031301031
1232100302311121
0112012023023012
1232003133321100
1211230320012110
2323211221032321
2212323303133101
2223310211312032
0203110103122000
1332020102321110
3300003201010033
2233023202120102
3012121022001233
1202212310000323
0101110321133031
