12221111
22111212
11122111
22112122
22222221
22121122
21111211
12122111
11121221
21122111
