22113221
22223211
13132111
23111231
22332113
21313112
11311323
12332213
22131232
33333211
