1232202100330220
3223222113023201
3221111203300001
0101130030000300
2203210221311321
2110322133233232
1110023030030132
3221210202221003
1102300333011213
3210023310113033
0211223233031021
2022312223303201
0121302102333203
0102131132132132
1112310122122103
2200213310311203
3211212133033130
2303333223232330
