0312021130011022
1023323000302200
3210002032021310
3302020221021030
1323221201000312
1102313100120213
0233113223130320
1132312011223320
2212320030103133
1123301100120021
0012202032330201
1322023331312120
3323023223230032
1323033200300120
3202330202321110
0312000200231032
0213010110212310
2033212032101201
