22221211
22212121
21122212
12211221
21121212
11122222
22222212
12111211
11112121
12112111
