1103020133
2313323111
2021101000
3222231101
3101233120
3232023310
3010001011
2013133213
0311003303
0220110233
3030322110
0333002332
2212103202
1023300312
1010002130
