3033223332
2102111203
3321331012
1132132320
2113122221
3121223233
2310232311
3200123312
1021011312
3203133130
2001011100
2323033231
3303012213
3110233001
1102100330
